886emvN5weQ	師大附中校歌	@NiceChord	#華語
3KwjYIb3bBQ	達拉崩吧	@Thumbelina Kali	#華語
eEX2qcjQP_U	體面	@阿勒 AlayKeru	#華語
iiPB5EOqHeI	Without You	@因為主人你太帥	#華語
LmC9qnjVAfA	我要靜一靜	@PPTG王霆鈞	#華語
LHrMkfDPdbA	洗碗精勇者	@幻夢行者楷菇	#華語
9W8uLBVoMto	突然好想你	@阿韋ahwei	#華語
Dl9jjoFYQlM	我難過	@哩厚音樂 LeadHope Music	#華語
0Zw5ksXF374	Mojito	@Ichy Lo一起羅	#華語
Aa1KloMRm2s	ハウトゥー世界征服	@LanSa	#華語
MR5-vhLwL_Q	粽子葉	@K楓悅	#華語
kSarY0vFTSU	達拉蹦吧	@吠勿的窩	#華語
TaFZgpUrUt4	千本幼女	@秋楓-UC日常	#華語
ceDkdqonZog	漂向北方	@阿賢AhYin	#華語
6qbK2NsjSZI	我的小可愛	@星月Moon	#華語
qWOaMasXYF8	神奇的朝代詩	@七忠32李哲楷Terry	#華語
gDe7PXWiZ68	願榮光歸香港	@Anson Yan	#華語
DeK8qhrvBSU	愛江山更愛美人	@YuYao	#華語
eEJpYv-mt1Y	履行	@星雨小傑StarainSJ	#華語
tJzsheS-DZk	小星星	@Visser	#華語
Cdb3h7H-P8g	如果有如果	@YuYao	#華語
7VaK67Quypc	芒種	@不死筆電	#華語
OurOiQN6tMU	鳳中校歌	@潘妮	#華語
DCIQEZKAr40	我只會螞蟻上樹	@DARKZIDEZ AKA NEVDAZO Official	#華語
hc0VMnXwm00	看不見的明天	@Lin Nagi	#華語
o6T0GZTJ7bM	水調歌頭	@Yee Din Liew	#華語
UV7lmZRwOM4	優酪乳少女	@幻夢行者楷菇	#華語
1Se_214xUZQ	如果我們不曾相遇	@阿韋ahwei	#華語
pGl0iMtO5RU	隱形的翅膀	@因為主人你太帥	#華語
aY1J6q8UTEc	Ievan Polkka	@Hugwalk	#日語	#其他
83ErZG18MqI	君をのせて	@Hugwalk	#日語
3mWMmipuCko	ダダダダ天使	@Kanoeki	#日語
LrQ7Rb-Alxk	天ノ弱	@アイスピック	#日語
EU4hMbi4csM	ゴーストルール	@アイスピック	#日語
IDwI9bB-XDQ	only my railgun	@tkt0506	#日語
UEz-vmiJMyE	恋は戦争 (Mwk Remix)	@アイスピック	#日語
V4LtnZOSmuA	妄想税	@アイスピック ︳冰錐	#日語
U-JmemjNZN4	ワールドイズマイン	@Pei	#日語
QqF_LeufJXU	君をのせて	@アイスピック ︳冰錐	#日語
1A262RrERA4	this game	@神姆	#日語
ZbYlU8nz6nQ	打上花火	@w飛龍	#日語
-vwUz69vkAc	Lemon	@アイスピック ︳冰錐	#日語
mICCb8UtaTM	Lemon	@阿木華	#日語
W5JlaVZzhwY	Bad Apple	@[Loser] Bang	#日語
9M4KZw0M4uw	ボッカデラベリタ	@鹿野遊山玩水	#日語
MyrCUDnYRw8	病名は愛だった	@がんチャンネル	#日語
6DOs953NFj8	Traitor's Requiem	@Stella Lin	#日語
_n_SwDFqciQ	Daddy Daddy do	@秋楓-UC日常	#日語
Q2CmFvzdG38	贖罪	@アイスピック ︳冰錐	#日語
ugeT6I9qBdc	ローリンガール	@Pei	#日語
mvzMrYZ33Gw	前前前世	@w飛龍	#日語
emxrLcWptyY	エイリアンエイリアン	@璃雪月RiSnowLuna	#日語
KLhDfELkNa0	Bad Apple	@StickFigure	#日語
_z5hj3V76Gw	前前前世	@StickFigure	#日語
ARtY3y36iFI	リバーシブル・キャンペーン	@小帕Lolipop	#日語
HHxhJIqecTg	アウターサイエンス	@潘妮	#日語
RmmVix_ex6I	Determination Symphony	@秋楓-UC日常	#日語
N1oQ6isGxhY	アンノウン・マザーグース	@柊	#日語
iOTs8hPWL68	病名は愛だった	@漩渦鳴櫻	#日語
xmHxyYaogCE	桜ノ雨	@Fu Nai	#日語
MUX1ZVarU7o	からくりピエロ	@霜夜	#日語
NfkKgLA1Q8A	TOOL	@アイスピック ︳冰錐	#日語
4KtuOzHkUzw	final phase	@神姆	#日語
nDs6CpAOCGg	たべるんごのうた	@暗淡星P	#日語
3D8NYqIVz68	Flamingo	@サカモトナナsakamoto nana	#日語
ABzWID-CTOk	邪魔	@鹿野遊山玩水	#日語
6FWvAXtbNGM	心做し	@Ceretsia	#日語
PPvyrc7ddcY	Bad Apple	@鄭皓	#日語
Zt-raHgqCIw	紅蓮の弓矢	@秋楓-UC日常	#日語
TelDSJNzUwQ	エイリアンエイリアン	@哆咖啦 DOKA	#日語
_xlGb7nnOHE	エイリアンエイリアン	@哆咖啦 DOKA	#日語
XmOcxN33nDg	ナユタン星人 - “猫猫的宇宙論”	@Kanoka	#日語
0tWhxPXs3Sk	Hearts	@リンネ 安堂	#日語
TkEab-WQMQo	wild side	@布不點	#日語
Ec8GO2x5CcQ	妄想税	@夏林克斯	#日語
yS1lYrmbzTQ	ベノム	@Ceretsia	#日語
es5bJOlk59Y	ゴーストルール	@Shizuku	#日語
vfpnF1Ar8Yg	靴の花火	@リンネ 安堂	#日語
HRh2IvILuBo	PONPONPON	@Henry L.	#日語
qkRtmst7oUo	Unravel	@神姆	#日語
87jKp70qyCQ	恋愛裁判	@修但幾咧	#日語
c1unlqtS7GU	Veil	@サカモトナナsakamoto nana	#日語
jfrfkZX7Ntk	やかん	@十円	#日語
oMRRE2P2OjA	How Your World	@Of Daaama	#日語
0jpKm3pbssY	firebird	@秋楓-UC日常	#日語
2PDnCwKhPxI	桜前線異常ナシ	@Stella Lin	#日語
tzNB12uziAI	adamas	@tkt0506	#日語
2MgVhWLTt3U	自傷無色	@常馨	#日語
Bzqwowjw2iA	Awake	@Stella Lin	#日語
UpFnQJ_fXEY	Butterfly	@千镽镺煞霧	#日語
cfMMDEYDUyE	心臓を捧げよ	@神姆	#日語
E3RArGmiWoY	リバーシブル・キャンペーン	@希羽	#日語
gt9YLoSiJwU	恋愛裁判	@Pei	#日語
K7lzUGN0ptg	Shadow is the Light	@神姆	#日語
s6QqTg72wrw	白い雪のプリンセスは	@_chocosecond二世	#日語
xKLGwR7KC3g	海色 MIIRO	@[Loser] Bang	#日語
mHm1zvr-c5I	桜ノ雨	@千夜連	#日語
PkktGMxfeVg	あなたにおくるアイの歌	@StickFigure	#日語
Nc1LxiB2z9c	高音厨音域テスト	@十円	#日語
8XbpBg2JNRc	ECHO	@アイスピック	#其他
uOkF3Gxtbtc	K.K. Bossa	@高橋昀曦	#其他
K72cO0146Qs	ロキ	@佐川コーラ	#MMD	#日語
r1URffE5OQ0	極楽浄土	@Nyxy Yang	#MMD	#日語
Fcoe-L6zYr4	Ievan Polkka	@佐川コーラ	#MMD	#日語	#其他
wI8L-ONVrAs	炉心融解	@佐川コーラ	#MMD	#日語
s1kliQSMJug	ゴーストルール	@日式烤企鵝	#MMD	#日語
wENNJjNjU84	ゴーストルール	@子夜yonaka	#MMD	#日語
e0qDlAMf4B8	Lemon	@若蔥	#MMD	#日語
k5A25EpIgXY	[A]ddition	@子夜yonaka	#MMD	#日語
D5chyjVDbbw	空中分解	@小帕Lolipop	#MMD	#日語
aOi1tSxMTjI	內湖金城武ノ日常觀察筆記	@Nyxy Yang	#MMD
N11Q0F7YNDQ	卑鄙源之助	@132 1123	#非歌曲
mYJhzcudSlw	Ievan polkka	@Caiseu225	#osu	#日語	#其他
s3bVDX69zig	施氏食獅史	@neotium zechs	#非歌曲
RVo7L83uozo	How哥的B-Box	@Richard Liang	#非歌曲
VGQ-e8HPa_U	紅鯉魚與綠鯉魚與驢	@柒哥erpet	#非歌曲
fFQ7uMOEMG8	How音未來玩狼人殺划水	@阿康請閉眼	#非歌曲
M2-PMj28Wro	在我們的星球眼淚不超過三秒	@Hugwalk	#華語
crH1BGTvk6o	蛋餅How朋友之歌	@NiceChord	#華語
I7C0sK0e1bo	李白	@_chocosecond二世	#華語
MV-jH3FDMDk	TAIWAN	@斐斐ㄈㄟˇ Felix	#華語
6EF9QrVM7lY	在我們的星球眼淚不超過三秒	@A 907	#華語
3YPU4bk3tus	我難過	@邱阿德A Der	#華語
NMKdlzngcfs	TAIWAN	@苦楓	#華語
1hDIyliLL0E	放手	@Hauer Hsieh	#華語
l9ejesbpG_U	芒種	@Aric _	#華語
i-zijeYlo90	鋼彈盪單槓	@墨栞-Blackbookmarks	#華語
yaefZeSTrNY	潑水歌	@Shigure Workshop	#華語
BBvq9PuPp5c	ロストワンの号哭	@LanSa	#華語
sbhPhm8r3gI	初嵐 ～First Storm～	@SeroTCS	#華語
l-Bq698tYuU	學貓叫	@Pistachio	#華語
ndaNz-lqckU	TAIWAN	@FIGHTER CHANNEL	#華語
zhVoeatHWbs	失眠	@劉伊 61	#華語
fX5Ubg4-hT8	夢語	@SeroTCS	#華語
qA7QN14P_FE	愛你一萬年	@羅橘	#華語
HcM_bxYYw5U	千本櫻	@Yesika Yoru	#日語
gk3lOhtxHhg	紅蓮華	@Hugwalk	#日語
qfADlrzqzL4	極楽浄土	@アイスピック	#日語
fermQLnTYgM	恋愛サーキュレーション	@がんチャンネル	#日語
zZW2aDffYkY	初音未來的消失	@獸人と蘿蔔	#日語
7tsv1mdzFYw	六兆年と一夜物語	@Pei	#日語
nZd_9Xansig	How哥宇宙	@Hugwalk	#日語
IfVEZ5ZA9cg	深海少女	@アイスピック	#日語
3idN_eKLnGw	PON PON PON	@がんチャンネル	#日語
A6VAqZaYqAc	シャルル	@maplestyle04	#日語
mRMcDlLGl70	乙女解剖	@_chocosecond二世	#日語
KY8cBE3NzV8	メルト	@Pei	#日語
Y1xRZygjFHA	威風堂々	@百灰	#日語
mY6qgMWziBI	紅蓮華	@アイスピック	#日語
aGX_nADyuHc	恋	@w飛龍	#日語
emeeZs1PCHc	マトリョシカ	@鹿野遊山玩水	#日語
NVo_Bx8QRE8	ロキ	@Elsa汵風	#日語
djLjSxuqlOY	平面説	@maplestyle04	#日語
NnogwbjuW6A	コネクト	@Elsa汵風	#日語
0OG5DkrF_sM	花燈の恋文	@影雪カゲゆき	#日語
tCFJfti-gXo	Brain Power	@Tamaki阿俊	#其他
Vp2CR-Uh4YM	Louder Machine	@Tamaki阿俊	#其他
JZBc4hpc4M8	B.B.K.K.B.K.K.	@Tamaki阿俊	#其他
j4SNfzRoqGw	Señorita	@Ichy Lo一起羅	#其他
-8jBp6lvFCY	낙화	@WindStar風過離殤	#其他
0-JY1lL39nk	Shooting Star	@Jinny老司機	#其他
jIwDDxh0aTo	Redzone	@修但幾咧	#其他
O1yL7fcDaqY	季姬擊雞記	@七先生	#非歌曲
fe2OT4xhtI0	罷韓國家隊	@數據實驗室-Data Lab	#非歌曲
x3e3XTjrBhQ	卑鄙O之助	@Upu Yang	#非歌曲
SdhtgUvgfjQ	How哥分享他產薯條的原則	@【凱延】Kai Yen	#非歌曲
dvevykLsODs	Brain Power	@Caiseu225	#osu	#其他
E8nNRcGDjAE	蛋餅How朋友之歌	@Caiseu225	#osu	#華語
-DTZbI73m1c	Louder Machine	@Caiseu225	#osu	#其他